



LEVEL - Test
........
.11.....
..22....
...33...
....44..
........
........
........









